Gg^Fds, Gd, Gg, Gg, Gg^Fds, Gg^Fds, Gg, Gs, Gg, Ss, Ss, Ss, Ss, Ss, Sm, Wwg, Ss, Ss, Ss, Ss, Ss, Wwg, Wwg, Wwg, Ss, Ss, Ss, Isa, Isa, Ss, Ss, Ss, Ss, Ss, Ss, Ss, Ss, Ss
Gg, Gg, Gs, Gd, Gg, Gg^Fds, Gg, Gd, Gg, Ss, Gd, Ss, Sm, Ss^Fds, Sm, Wwg, Ss, Ss^Fds, Ss, Sm, Isa, Wwg, Ss, Ss^Fds, Ss^Fds, Ss, Ss^Fds, Ss, Sm, Isa, Isa, Ss, Sm, Sm, Ss^Fds, Sm, Wwg, Wwg
Gg^Fds, Gd, Gg, Gs, Gd, Gg^Fds, Gg^Fds, Gg, Gg, Ss, Ss, Gd, Sm, Ss, Ss, Wwg, Wwg, Ss, Isa, Isa, Sm, Isa, Isa, Sm, Gd, Ss, Ss^Fds, Ss^Fds, Ss, Sm, Ss^Fds, Isa, Isa, Ss, Ss, Ss, Wwg, Wwg
Gg, Gg, Gg, Gs, Gs, Gg^Fds, Gg, Gg^Fds, Gd, Gs, Ss, Ss, Gd, Ss, Sm, Ss, Isa, Isa, Ss, Wwg, Ss, Wwg, Ss, Isa, Isa, Gd^Vka, Ss^Fds, Ss, Ss, Ss, Isa, Isa, Ss, Sm, Sm, Ss^Fds, Ss, Wwg
Gs, Gg^Fds, Gg^Fds, Gg, Gg, Gg, Gg, Gg, Gg^Fds, Gs, Sm, Sm, Ss, Ss^Fds, Isa, Isa, Ss^Vka, Wwg, Wwg, Wwg, Ss^Fds, Wwg, Ss, Gd, Isa, Isa, Ss^Fds, Ss, Gd^Edb, Isa, Ss, Ss, Ss, Ss^Fds, Sm, Ss, Wwg, Wwg
Gg, Gs, Gg, Gg, Gd, Gg, Gg^Fds, Gg, Gg^Fds, Sm, Ss, Ss, Ss, Isa, Isa, Gd, Wwg, Ss, Wwg, Ss^Fds, Wwg, Wwg, Isa, Isa, Ss, Ss, Gd, Gd, Ss, Sm, Sm, Sm, Ss^Vka, Ss, Sm, Wwg, Ss, Wwg
Gg^Fds, Gg, Gg^Fds, Gg, Gg, Gg, Gd, Gd, Gg^Fds, Sm, Ss, Ss, Gd, Ss, Ss, Isa, Isa, Wwg, Ss, Ss^Fds, Wwg, Isa, Isa, Ss, Ss, Ss, Gd, Ss, Gd^Edb, Ss^Fds, Ss, Ss, Isa, Ss, Ss, Ss, Ss, Wwg
Gg, Gg, Gg, Gd, Gs, Gd, Gd, Gg^Fds, Gg, Gd, Ss, Ss, Sm, Ss, Gd, Ss^Fds, Wwg, Isa, Isa, Ss, Ss, Wwg, Gd^Vka, Isa, Isa, Sm, Sm, Gd^Vka, Sm, Sm, Isa, Isa, Ss, Gd^Ebn, Ss, Ss, Ss, Ss
Gg, Gs, Gg^Fds, Gg, Gd, Gg^Fds, Gd, Gg^Fds, Ss, Ss, Gs, Ss, Gd, Ss, Gd^Edb, Gd^Vka, Isa, Isa, Ss^Fds, Ss, Sm, Wwg, Wwg, Wwg, Ss, Isa, Isa, Ss, Isa, Isa, Ss, Ss, Ss, Ss, Khs, Ss, Sm, Ss
Gd, Gg^Fds, Ce, Ce, Gg, Gg, Gs, Gs, Gs, Sm, Sm, Ss, Ss, Ss, Isa, Isa, Wwg, Wwg, Ss, Ss, Isa, Wwg, Wwg, Sm, Ss, Sm, Ss, Isa, Isa, Ss, Sm, Khs, Chs, Ss^Edb, Ss^Edb, Ss^Edb, Chs, Khs
Gd, Gg, Ce, 1 Ket, Gg, Gd, Gg^Fds, Gs, Gs, Ss, Gd, Gd, Isa, Isa, Ss, Ss, Ss, Wwg, Isa, Isa, Ss, Isa, Isa, Gd, Ss^Vka, Gd, Ss, Ss, Gd, Isa, Isa, Ss, Ss, Chs^Edb, 2 Khs^Edb, Chs^Edb, Ss, Ss
Gg, Gg, Gg, Ce, Gg, Gg, Gg^Fds, Gs, Gg^Fds, Gd, Gd, Gs, Gs, Isa, Isa, Sm, Isa, Isa, Ss, Ss, Sm, Ss, Wwg, Isa, Isa, Ss, Ss, Ss, Ss, Gd^Edb, Ss, Isa, Isa, Sm, Chs^Edb, Ss^Fds, Khs, Ss
Gg^Fds, Gs, Gg^Fds, Gg, Gs, Gg^Fds, Gd, Gs, Gg^Fds, Gd, Sm, Ss, Gd, Sm, Ss, Isa, Ss, Ss, Sm, Ss, Ss^Fds, Gd, Ss, Ss, Isa, Isa, Ss^Edb, Ss, Ss, Ss^Fds, Sm, Ss^Fds, Ss^Vka, Isa, Chs, Ss, Ss, Ss
Gg^Fds, Gg, Gg, Gs, Gg, Gg^Fds, Gg, Gs, Gs, Gd, Gd^Edb, Ss, Gd, Ss, Gd, Ss, Gd, Sm, Ss^Vka, Ss, Sm, Ss, Isa, Isa, Ss^Fds, Ss, Ss, Sm, Isa, Sm, Ss^Fds, Gd^Edb, Ss, Sm, Khs, Sm, Ss, Ss
Gg, Gg, Gg^Fds, Gg, Gd, Gg, Gg, Gg^Fds, Gg^Fds, Sm, Gd, Gs, Ss^Vka, Sm, Ss, Ss, Wwg, Wwg, Wwg, Sm, Isa, Isa, Sm, Sm, Gd, Ss, Sm, Sm, Ss, Isa, Isa, Gd^Edb, Sm, Sm, Ss^Fds, Sm, Ss, Ss
Gg, Gd, Gg^Fds, Gg^Fds, Gd, Gg^Fds, Gg, Gg, Gg, Ss, Gs, Sm, Ss, Sm, Ss, Ss, Isa, Wwg, Ss^Fds, Ss, Ss^Vka, Isa, Isa, Ss, Ss, Sm, Ss^Edb, Gd^Vka, Sm, Ss^Fds, Sm, Isa, Isa, Ss, Ss^Fds, Sm, Ss, Ss
Gd, Gg^Fds, Gg, Gs, Gg^Fds, Ss, Ss, Gg, Gg, Gs, Ss, Gs, Gd, Ss, Isa, Isa, Ss^Fds, Isa, Isa, Gd, Sm, Ss^Fds, Ss, Isa, Isa, Ss^Fds, Ss, Ss, Sm, Ss, Isa, Isa, Ss, Sm, Wwg, Wwg, Ss, Ss
Gg, Gg^Fds, Gs, Gg^Fds, Gd, Gg^Fds, Gs, Gs, Gs, Ss, Gs, Ss, Isa, Isa, Sm, Sm, Ss, Ss, Ss, Isa, Isa, Ss, Isa, Isa, Ss^Fds, Ss, Gd^Vka, Sm, Isa, Isa, Ss^Edb, Ss^Edb, Ss, Ss^Vka, Wwg, Ss, Wwg, Ss
Gg^Fds, Gg, Gs, Gg^Fds, Gg^Fds, Gg^Fds, Gg^Fds, Gs, Gs, Gd, Ss, Gd, Gs, Ss, Ss^Fds, Ss, Ss, Sm, Ss, Ss, Ss, Isa, Ss^Fds, Ss, Ss, Gd, Sm, Ss, Ss, Sm, Sm, Sm, Wwg, Ss, Ss, Wwg, Wwg, Wwg
Gg^Fds, Gd, Gg, Gg, Gd, Gs, Gd, Gd, Gd, Ss, Ss, Ss, Ss, Ss, Ss, Ss^Edb, Ss, Ss, Ss, Ss, Ss, Ss, Ss, Ss, Ss, Ss, Ss, Ss, Ss, Ss, Wwg, Ss, Wwg, Wwg, Wwg, Wwg, Wwg, Wwg
