Mm, Hh^Fp, Mm, Mm, Mm, Mm, Mm, Mm, Mm, Mm, Mm, Mm, Hh^Fms, Hh^Fp, Hh^Fms, Gll^Fp, Gg^Fms, Cvr^Fp, Gg^Fms, Gll^Fp, Gg^Fms, Gg^Fms, Gg^Fms, Gg^Fms, Gg^Fms, Gg^Fms, Hh^Fms, Gg^Fp, Gg^Fp, Gg^Fp
Mm, Mm, Mm, Mm, Mm, Mm, Ww, Ww, Ww^Ewf, Mm, Hh^Fp, Cvr^Fms, Hh^Fms, Hh^Fms, Hh^Fms, Hh^Fms, Hh^Fms, Gg^Fms, Hh^Fp, Gll^Fp, Hh^Fms, Hh^Ve, Hh^Fms, Hh^Fms, Cv^Fms, Gg^Fms, Cv^Fms, Hh^Fms, Gg^Fms, Gg^Fp
Hh^Fms, Hh^Fms, Mm, Mm, Mm, Gs^Fet, Gs^Fda, Ww^Ewl, Gg^Fp, Hh^Fms, Hh^Fp, Hh^Fp, Gg^Fms, Hh^Fms, Gg^Fms, Gg^Fms, Hh^Fms, Gg^Fms, Hh^Fp, Hh^Fms, Hh^Fms, Hh^Fms, Hh^Fp, Cv^Fms, Kv, Cv^Fms, Kv, Cv^Fms, Gg^Fms, Gg^Fms
Hh^Fms, Hh^Fms, Hh^Fms, Gll^Fp, Hh^Fms, Gs^Fda, Aa^Ve, Gs^Fda, Gg^Fp, Gll^Fms, Hh^Fp, Gll^Fp, Gg^Fms, Gg^Fms, Hh^Fms, Hh^Fms, Hh^Fms, Hh^Fms, Hh^Ve, Hh^Fms, Gll^Fms, Hh^Fms, Gg^Fms, Cv^Fms, Cv^Fms, 2 Kv, Cv^Fp, Cv^Fms, Gg^Fms, Gg^Fms
Mm, Mm, Mm, Hh^Fms, Hh^Fms, Gs^Fda, Gs^Fda, Gs^Fda, Hh^Fms, Gg^Fp, Hh^Fms, Hh^Fms, Gg^Fms, Gll^Fp, Gg^Fms, Hh^Fms, Gll^Fp, Hh^Fp, Gll^Fms, Gg^Fp, Gg^Fp, Gg^Fp, Gg^Fp, Gg^Fms, Cv^Fp, Kv, Cv^Fp, Gg^Fp, Gg^Fp, Gg^Fms
Mm, Mm, Mm, Hh^Fp, Hh^Fp, Hh^Fms, Gg^Fp, Gg^Fp, Gg^Fp, Gll^Fms, Hh^Fms, Hh^Fms, Gg^Fp, Gg^Fms, Gg^Fms, Gg^Fms, Hh^Fms, Hh^Fp, Gll^Fp, Hh^Fms, Gg^Fp, Gll^Fms, Gg^Efm, Gg^Fms, Gg, Cv^Fp, Gg^Fms, Hh^Fms, Hh^Fms, Gg^Fp
Mm, Mm, Gg^Fms, Gll^Fp, Hh^Fms, Hh^Fms, Hh^Fms, Gll^Fms, Hh^Fms, Gll^Fms, Gll^Fms, Hh^Fms, Gg^Fp, Gg^Fms, Gg^Fms, Hh^Fp, Gg^Fms, Gg^Fms, Hh^Fms, Hh^Fms, Gg^Fp, Gg, Gg, Gg, Gll, Gg^Fp, Gg^Fms, Hh^Fp, Hh^Fms, Gg^Fp
Mm, Hh^Fp, Gg^Fms, Hh^Fms, Hh^Fms, Gll^Fms, Gll^Fms, Gll^Fms, Gll^Fp, Hh^Fms, Cvr^Fms, Gll^Fms, Gg^Fp, Gg^Fms, Gg^Fms, Gg^Fms, Hh^Fms, Gll^Fp, Gll^Fms, Gg^Fp, Gg, Gll, Gg, Gg, Gg^Fms, Gll^Fms, Gg^Fms, Hh^Ve, Gll^Fms, Gg^Fp
Gll^Fp, Hh^Fms, Gg^Fms, Hh^Fms, Hh^Fms, Hh^Fp, Hh^Fms, Gs^Fms, Hh^Fms, Hh^Fms, Hh^Fms, Gll^Fms, Gll^Fms, Gg^Fp, Hh^Fp, Hh^Fms, Gll^Fms, Gll^Fms, Gll, Gll^Fms, Gg, Gg^Efm, Gg^Fms, Gg, Gll^Efm, Gg^Fms, Gg^Fms, Hh^Fms, Gg^Fp, Gg^Fp
Gg^Fms, Gg^Fms, Gg^Fms, Gg^Fms, Gg^Fms, Gg^Fms, Hh^Fms, Hh^Fms, Gll^Fms, Hh^Fms, Gll^Fms, Gll^Fms, Gg^Fp, Gg^Fp, Hh^Fp, Gll^Fp, Gll, Gg, Gg, Gg, Gll, Gll, Gg^Efm, Gg, Gll^Fms, Gll^Fp, Hh^Fp, Hh^Fms, Cvr^Fp, Gg^Fp
Gg^Fms, Gg^Fms, Hh^Fms, Hh^Fms, Hh^Fms, Hh^Fms, Hh^Fms, Gll^Fms, Hh^Fms, Hh^Fp, Hh^Fms, Gll^Fms, Hh^Fms, Hh^Fms, Gll^Fms, Gll^Fp, Gg^Efm, Gg^Fms, Gg, Gg^Efm, Gg, Gll, Gg^Fms, Gg^Fms, Hh^Fms, Hh^Fms, Hh^Fms, Hh^Fms, Gg^Fp, Gg^Fp
Hh^Fms, Hh^Fms, Gll^Fp, Hh^Fms, Gll^Fms, Hh^Fms, Hh^Fms, Hh^Fms, Gll^Fms, Hh^Fms, Hh^Fms, Hh^Fms, Gll^Fms, Gll^Fms, Gll^Fms, Gg, Gll, Gg, Gg^Fms, Gg^Efm, Gll^Fp, Gg^Fms, Gg^Fms, Cvr^Fp, Gg^Fms, Gg^Fms, Hh^Fms, Hh^Fms, Gg^Fp, Gg^Fp
Hh^Fms, Hh^Fms, Gll^Fms, Cvr^Fms, Hh^Fms, Hh^Fms, Gg^Fp, Gll^Fms, Hh^Fms, Gll^Fms, Gll^Fms, Gll^Fp, Gll^Fms, Gll^Fms, Gg, Gg, Gg^Efm, Gg^Ve, Gg, Gll^Fp, Gg^Fms, Gg^Fms, Hh^Fms, Gg^Fms, Gg^Fms, Gg^Fms, Gll^Fp, Hh^Fp, Gll^Fms, Gg^Fp
Hh^Fms, Hh^Fms, Hh^Fms, Hh^Fms, Gll^Fms, Gg^Fp, Gll^Fms, Hh^Fp, Gll^Fms, Gll^Fms, Gll, Gll^Fms, Gg^Efm, Gll, Gg, Gg^Fms, Gg^Fms, Gll, Gg^Fms, Gg^Fms, Hh^Fms, Hh^Fms, Gg^Fms, Gll^Fp, Gg^Fms, Gg^Fms, Gg^Fms, Hh^Fms, Gll^Fms, Gg^Fp
Hh^Fms, Hh^Fp, Hh^Fms, Hh^Fp, Hh^Fp, Gll^Fms, Hh^Fp, Hh^Fms, Gll^Fp, Gll^Efm, Gg^Ve, Gg^Fms, Gll, Gg, Gll^Efm, Gg, Gll^Fp, Gg^Fms, Gg^Fms, Gll^Fp, Hh^Fms, Hh^Fms, Gg^Fms, Gg^Fms, Hh^Fms, Gll^Fp, Hh^Fms, Hh^Fms, Hh^Fms, Gg^Fp
Gll^Fms, Gll^Fms, Hh^Fms, Hh^Fms, Hh^Fms, Cvr^Fp, Gll^Fp, Gll^Fms, Gg, Gg, Gg^Fms, Gg, Gg, Gg, Gg, Gg, Gll^Fp, Gg^Fms, Hh^Fms, Hh^Fms, Hh^Fp, Gll^Fp, Gll^Fp, Gg^Fms, Hh^Fms, Gll^Fms, Gll^Fms, Cvr^Fms, Hh^Fms, Gg^Fp
Gll^Fp, Gll^Fp, Hh^Fms, Hh^Fp, Hh^Fms, Hh^Fms, Gg^Fms, Gll^Fp, Gll, Gll, Gg, Gg, Gll^Efm, Gg^Fms, Gll^Fms, Gll^Fp, Hh^Fp, Hh^Fp, Gg^Fms, Gll^Fp, Hh^Fp, Gll^Fms, Hh^Fms, Hh^Fms, Gg^Fms, Gll^Fp, Hh^Fms, Hh^Fp, Hh^Fms, Gg^Fp
Gll^Fp, Gg^Fms, Gg^Fms, Gg^Fms, Gg^Fms, Gg^Fms, Gg^Fms, Gg, Gg^Efm, Gll, Gg, Gg, Gll, Gg^Fp, Gg^Fp, Hh^Fp, Hh^Fms, Gg^Fms, Gg^Fms, Gg^Fms, Hh^Fms, Hh^Fms, Hh^Fms, Hh^Fp, Gg^Fms, Gg^Fms, Hh^Fms, Gll^Fms, Gll^Fms, Hh^Fms
Gs^Fms, Gll^Fp, Gg^Fms, Gg^Fms, Gs^Fp, Gg^Fms, Gg, Gll, Gg, Gg, Gg, Gg^Fp, Gg^Fp, Gg^Fp, Hh^Fms, Hh^Fms, Hh^Fms, Hh^Fms, Hh^Fms, Cvr^Fp, Gll^Fms, Hh^Fms, Hh^Fms, Hh^Fms, Gg^Fms, Gg^Fms, Hh^Fms, Gll^Fms, Ww, Wo
Gs^Fms, Gs^Fp, Gs^Fp, Gs^Fp, Gs^Fp, Gs^Fms, Gg, Gg, Gg, Gg, Gg, Gll, Gg^Fp, Gg^Fp, Gg^Fms, Gg^Fms, Gg^Fms, Hh^Fms, Hh^Fms, Hh^Fms, Hh^Fms, Hh^Fms, Gg^Fms, Gg^Fms, Gll^Fp, Hh^Fp, Hh^Fms, Hh^Fms, Wo, Wo
Gs^Fms, Gs^Fms, Gg, Gg, Gg, Gg, Gg, Gg, Gg, Gg, Gg, Gg, Gg, Gg^Fms, Gg^Fms, Gg^Fp, Gg^Fp, Gg^Fp, Hh^Fp, Gg^Fp, Gg^Fp, Gg^Fp, Gg^Fms, Gll^Fp, Gg^Fms, Gll^Fp, Hh^Fms, Hh^Fms, Wo, Wo
Gg, Gg, Gg, Gg, Gg, Gg, Gg, Gg, Gg, Gg, Gg, Gg, Gg, Gg^Fms, Gg^Fms, Gg^Fms, Gg^Fms, Gg^Fp, Gg^Fp, Gg^Fp, Gg^Fms, Gg^Fms, Hh^Fp, Gg^Fms, Hh^Fms, Hh^Fms, Hh^Fms, Ww, Wo, Wo
Gg, Gg, Gg, Gg, Gg, Gg, Gg, Gg, Gg, Gg, Gg, Gg, Gg, Gg, Gg^Fp, Gs^Fms, Gg^Fp, Gg^Fms, Gg^Fp, Gg^Fms, Gll^Fp, Gg^Fms, Gg^Fms, Hh^Fms, Hh^Fms, Ww, Ww, Ww, Wo, Wo
Gg, Gg, Gg, Gg, Gg, Gg, Gg, Gg, Gg, Gg, Gg, Gg, Gg, Gs, Gg, Gg^Fp, Gg^Fms, Gs^Fms, Gg^Fms, Gg^Fms, Gg^Fms, Gg^Fms, Gs^Fms, Hh^Fms, Hh^Fp, Hh^Fms, Ww, Wo, Hh^Fp, Hh^Fp
Gg, Gg, Gs^Es, Gs, Gs, Gs, Gg, Re^Vct, Gs, Gs, Gs, Gg, Gg, Gg, Gg, Gs^Fms, Gg^Fp, Gg^Fms, Gll^Fms, Gg^Fms, Gll^Fp, Cvr^Fms, Hh^Fp, Hh^Fp, Hh^Fms, Ww, Wo, Wo, Cvr^Fms, Gll^Fms
Gs, Gs, Gs, Gs, Gs, Gs, Re, Re, Ce, Gs, Gs, Gg, Gg, Gg, Gg, Gg, Gg^Fp, Gs^Fms, Gg^Fp, Gll^Fp, Gg^Fms, Gll^Fp, Hh^Fp, Hh^Fms, Ww, Ww, Wo, Wo, Wo, Wo
Gs, Gs, Gs, Gg, Re, Re, Ce, Ce, 1 Ke, Ce, Gs, Gs, Gs, Gg, Gg, Gs^Fms, Gs^Fp, Gg^Fp, Gg^Fms, Gll^Fms, Gg^Fms, Hh^Fms, Ww, Ww, Wo, Wo, Wo, Wo, Ww, Ww
Gs, Gs, Gs^Es, Gs, Re, Gs, Gs, Ce, Gg, Gs, Gs, Gs^Es, Gg, Gg, Gg, Gg^Fp, Gg^Fms, Gg^Fms, Gs^Fms, Gg^Fms, Gll^Fp, Gll^Fp, Ww, Ww, Wo, Wo, Wo, Ww, Ww, Gll^Fp
Gs, Gg, Re, Re, Gs, Re^Vct, Gg, Gs, Gs, Gs, Gs, Gg, Gg, Gg, Gs^Fp, Gs^Fp, Gs^Fms, Gs^Fp, Gg^Fms, Gll^Fp, Ww, Ww, Wo, Wo, Wo, Wo, Ww, Ww, Gll^Fp, Gll^Fp
Gg, Gs^Es, Re, Gs, Gs, Gs^Es, Gs, Gs, Gs, Gs^Es, Gg, Gs, Gs, Gs^Fp, Gg, Gs^Fms, Gll^Fp, Gll^Fp, Gg^Fms, Gll^Fp, Ww, Wo, Wo, Wo, Ww, Ww, Gll^Fp, Gll^Fp, Gll^Fp, Gll^Fp
