Mm, Mm, Mm, Mm, Mm, Mm, Mm, Mm, Mm, Mm, Mm, Mm, Mm, Mm, Mm, Mm, Mm, Mm, Mm, Mm, Mm, Mm, Mm, Mm, Mm, Mm, Mm, Mm, Mm, Mm, Mm, Mm
Uu, Mm, Uu, Uu, Uu, Uu, Mm, Uu, Mm, Mm, Uu, Uu, Uu, Mm, Mm, Mm, Mm, Mm, Mm, Uu, Mm, Uu, Uu, Mm, Uu, Mm, Uu, Mm, Mm, Mm, Uu, Uu
Mm, Uu, Ur, Uh, Ur, Urb, Ur, Urb, Ur, Urb, Uh, Ur, Ur, Uh, Uu, Ql, Ql, Urb, Uu, Ur, Uh, Ur, Ur, Ur, Uh, Ur, Ur, Ur, Ur, Urb, Mm, Mm
Mm, Mm, Ur, Ur, Uh, Uu, Ur, Uh, Ur, Urb, Uu, Urb, Urb, Uh, Ur, Ql, Ql, Ur, Urb, Ql, Ur, Ur, Uu, Uu, Ur, Uu, Uh, Ur, Urb, Ur, Uu, Mm
Mm, Uu, Ur, Ur, Urb, Uu^Vu, Urb, Ur, Uu, Ur, Ur, Ur, Urb, Ur, Ur, Ql^Bsb/, Ql^Bsb/, Uu, Ur, Ur, Ur, Ur, Uh, Uu, Urb, Uh, Uu, Urb, Ur, Ur, Mm, Mm
Mm, Uu, Urb, Uh, Ur, Urb, Uh, Uu, Ur, Ur, Ur, Ur, Uu, Mm, Mm, Ql, Ql, Ur, Ur, Ur, Uh, Ur, Ur, Ur, Uh, Urb, Uu^Vu, Ur, Uu, Uu, Uu, Mm
Mm, Mm, Urb, Uh, Ur, Ur, Ur, Ur, Ur, Ur, Urb, Uh, Ur, Mm, Mm, Uh, Ql, Ql, Urb, Ur, Ur, Ur, Ur, Uh, Urb, Ur, Ur, Uu, Ur, Uu, Mm, Mm
Mm, Uu, Ur, Urb, Ur, Ur, Uh, Ur, Uu, Ur, Uh, Urb, Ur, Mm, Mm, Mm, Uu, Ql, Ql, Urb, Ur, Uh, Mm, Mm, Ur, Uh, Ur, Ur, Uu, Uh, Mm, Mm
Mm, Mm, Uh, Urb, Uu, Uu, Uu, Ur, Uh, Uu, Ur, Uu, Uh, Urb, Urb, Ur, Ql, Ql, Uh, Hh, Hh, Mm, Mm, Mm, Hh, Hh, Ur, Ur, Uh, Ur, Mm, Mm
Mm, Mm, Ur, Urb, Ur, Ur, Uu, Ur, Ur, Ur, Ur, Uu, Uh, Ur, Ur, Ur, Ur, Ql, Ql, Hh, Hh, Mm, Mm, Mm, Hh, Ur, Uu, Ur, Urb, Ur, Uu, Mm
Mm, Mm, Uu, Ur, Uu, Uu, Ur, Ur, Urb, Uh, Ur, Urb, Ur, Ur, Ur, Uh, Ql, Ql, Ur, Hh, Hh, Hh, Hh, Hh, Hh, Hh, Ur, Urb, Ur, Uh, Uu, Mm
Mm, Mm, Urb, Urb, Ur, Ce, Ur, Ur, Ur, Urb, Hh, Hh, Hh, Ur, Uh, Uh, Ql, Ql, Urb, Uh, Ur, Ur, Ur, Ur, Urb, Ch, Ch, Ch, Ur, Urb, Mm, Mm
Mm, Uu, Urb, Uu, Ce, 1 Ke, Ce, Uu, Ur, Urb, Hh, Hh, Hh, Uh, Uh, Urb, Uu^Vu, Ql^Bsb/, Ql^Bsb/, Uu, Uh, Ur, Urb, Ur, Ur, Ch, 2 Kh, Ch, Ur, Urb, Uu, Mm
Mm, Uu, Ur, Ur, Ce, Ce, Ce, Uh, Ur, Ur, Hh, Hh, Hh, Uh, Uh, Ur, Uu, Ql, Ql, Ur, Uh, Hh, Urb, Urb, Ur, Uu, Ch, Ur, Urb, Ur, Mm, Mm
Mm, Mm, Urb, Urb, Ur, Urb, Uu, Ur, Uh, Uh, Ur, Uu, Uh, Ur, Uu, Ur, Ur, Ql, Ql, Uh, Ur, Hh, Hh, Hh, Ur, Ur, Ur, Uu, Ur, Uh, Mm, Mm
Mm, Mm, Hh, Uu, Hh, Ur, Ur, Uh, Urb, Ur, Uu, Ur, Ur, Ur, Ur, Uu, Uh, Mm, Mm, Mm, Uh, Hh, Hh, Ur, Ur, Urb, Uh, Ur, Urb, Ur, Uu, Mm
Mm, Mm, Hh, Hh, Hh, Uh, Ur, Ur, Ur, Uu, Ur, Ur, Uu, Uu, Ur, Ur, Ql, Mm, Mm, Mm, Urb, Ur, Ql, Ur, Ur, Ur, Uh, Urb, Uu, Uh, Mm, Mm
Mm, Uu, Hh, Ur, Hh, Urb, Ur, Uu, Ur, Urb, Urb, Uh, Urb, Uu, Uu, Ur, Mm, Mm, Mm, Ur, Uh, Ur, Uh, Hh, Uu, Hh, Ur, Urb, Urb, Ur, Uu, Mm
Mm, Mm, Ur, Ur, Ur, Ur, Ur, Ur, Uh, Urb, Ur, Urb, Urb, Ur, Uu, Ur, Ql, Mm, Mm, Urb, Urb, Urb, Uu, Hh, Hh, Hh, Uh, Uh, Uh, Uu, Uu, Mm
Mm, Uu, Ur, Uu, Uh, Urb, Uh, Uh, Uh, Uu, Ur, Urb, Ur, Ur, Uu, Ur, Mm, Mm, Mm, Ur, Uu, Ur, Uu, Hh, Hh, Hh, Ur, Uu^Vu, Urb, Ur, Uu, Mm
Mm, Mm, Ur, Uh, Uu^Vu, Ur, Uh, Ur, Uh, Uu, Ql, Ur, Uh, Uu, Ur, Ur, Ql, Ql, Uu, Ur, Uh, Ur, Urb, Urb, Uu, Urb, Uu, Uh, Ur, Urb, Uu, Mm
Mm, Mm, Ur, Ur, Uh, Uu, Uu, Urb, Ur, Ur, Ur, Uu, Urb, Ur, Urb, Uu, Ql, Ql, Ur, Ur, Uh, Ur, Uu, Ur, Ur, Ur, Urb, Urb, Ur, Ur, Mm, Mm
Uu, Uu, Mm, Mm, Mm, Uu, Mm, Uu, Mm, Mm, Mm, Uu, Uu, Mm, Mm, Mm, Uu, Uu, Mm, Mm, Mm, Uu, Uu, Mm, Uu, Uu, Uu, Mm, Mm, Mm, Mm, Mm
Mm, Mm, Mm, Mm, Mm, Mm, Mm, Mm, Mm, Mm, Mm, Mm, Mm, Mm, Mm, Mm, Mm, Mm, Mm, Mm, Mm, Mm, Mm, Mm, Mm, Mm, Mm, Mm, Mm, Mm, Mm, Mm