Gs, Gd, Gs, Hh, Hh, Hh, Gg^Fds, Gg, Gg, Gd, Gs, Gg^Fds, Gg, Gs, Gs, Gs, Gd, Gg, Gg, Gs, Gg, Gg, Gg, Hh, Gg, Gs, Gg, Rp, Hh, Gs
Gs, Gg, Gg, Gg, Gg, Gg, Gg, Gs, Gs, Gg, Gg^Edb, Gg, Gg, Gg^Edb, Gg, Gd, Gg, Gg, Gg, Gg, Gg, Gd, Gg^Ecf, Gg, Gs^Edb, Gg, Rp^Edb, Rp, Gs, Gs
Gs, Gg, Gg, Gs, Gg, Gs, Gd, Gg, Gg, Gg, Gg, Gs, Gg, Gg, Gg, Gg, Gg, Gg, Gg, Gs, Gs, Gg, Gg, Gg, Gg, Gd, Gg, Gd, Gg, Gs
Gs, Gg, Gg, Gg, Gg, Gs, Gg^Edb, Gg, Gg, Gg, Gg, Gs, Gg, Gg, Gg, Hh, Hh, Gd, Hh, Gg, Gg, Gg, Gg, Gg, Gd, Rp, Gg, Gg, Gs, Gd
Gs, Gg, Gg, Gs, Gs, Gg, Gg, Gg, Gg, Gd, Gg, Gg, Gd, Gg, Gs, Hh, Hh, Hh, Hh, Gg, Gg, Gg, Gd^Edb, Gg^Fds, Gd, Rp, Gd, Gs, Gg, Gg^Edb
Gg, Gs, Gd, Gd, Gd, Gd, Gg, Gg, Gd, Gg, Gs, Gg, Gs, Gd, Gg, Gs, Gg, Gg, Gg, Gd, Gg, Gd, Gg, Gd, Gd, Rp, Gg, Gg, Gs, Gs
Gs, Gg, Gg, Gg, Re, Gd, Re, Gg, Gg, Gs, Gg, Gg, Gg, Gg^Edb, Gs, Gg, Gs, Gs, Gs^Ecf, Gd, Gd^Edb, Gd, Gd, Gd, Rp, Rp, Gg, Gs, Gg, Gd
Gg, Gd, Gg, Gd, Re, Re, Re, Gg, Gg, Re, Re, Gs, Gs, Gg, Gg, Gs, Gg, Gd, Gg, Gd, Gd, Hh, Gg, Rp, Rp, Gs^Edb, Gg, Gg, Gs^Fds, Gg^Fds
Gs, Gd, Gg, Gd, Re, Re, Re, Gg, Gd, Re, Gs, Re, Hh, Gs, Gs, Gs, Gs, Gs, Gs, Gs, Gg, Gd, Rp, Rp, Gg, Gg, Gs, Gs, Gd, Gg^Fds
Gs, Gg, Ce, Gs, Gd, Gd, Gd, Gg, Gg, Gg, Gg, Gs, Gd, Hh, Gg, Gs, Gg, Gs, Gs, Gs, Rp, Rp, Gd, Gs^Ecf, Gs, Gs, Gs, Gs, Gs^Ecf, Hh
Rp, Rp, 1 Ke, Ce, Rp, Rp, Rp, Rp, Rp, Rp, Rp, Gg, Rp, Gd, Gs, Gg, Gg^Edb, Gg, Gg, Rp, Gg, Gg, Gg, Gs, Gs, Gg, Gg, Gd, Gg, Gg
Gg, Gg, Gg, Ce, Gd, Gd, Gd, Gd, Gd, Gg, Gg, Gs, Gs, Rp, Rp, Gs, Gs, Gg, Rp, Rp, Gg, Gg, Gg, Gg, Gg, Gg, Gg, Gs, Gg, Hh
Gs, Gs, Gs, Gg, Gg, Gg, Gg, Gd, Gd, Gg, Gs, Gg, Gg, Gg, Gg, Rp, Gg, Gs, Gs, Gg, Gg, Gg, Gd, Gd, Gd, Gg, Gg, Gg, Gg, Gs
Gg, Gg, Gg, Gg, Gg, Gg, Gg, Gd, Gd, Gd, Gg, Gg, Gs, Gg^Edb, Gd, Gg^Fds, Gg, Gg, Gg, Gg, Gg, Gg, Gd, Gs, Gd, Gd, Gg, Gs, Hh, Hh
Gs, Gd, Gg, Gg, Gs, Gs, Gs, Gd, Gd, Gd, Gg, Gs, Gs, Gg, Gs, Gg, Gg, Gg, Gg, Gs, Gg, Gg^Edb, Gd, Gd, Gs, Gs, Gg, Gg, Gg, Hh
Gg^Fds, Gg, Gg, Gg, Re, Re, Re, Gd, Gd, Gd, Gs, Gg, Gg, Gg, Gd^Edb, Gg, Gg, Gg, Gg, Gg, Gg, Gg, Gg^Ecf, Gg, Gg, Gg, Gd, Gg, Gd, Gg
Gg, Gg, Gs, Gs, Re, Re, Hh, Gg, Gg, Gg, Gg^Edb, Gg, Gg, Gs, Gg, Gg, Gs, Gs, Gd, Gg, Gg, Gg, Gg, Gg, Gd, Gg, Gg, Gs, Gg, Gg
Gs, Gg, Gd, Gs, Gs, Gg, Gg, Gs, Gg, Gg^Edb, Gg, Gg, Gg, Gg, Gg, Hh, Hh, Hh, Hh, Gg, Gg^Fds, Gg, Gg, Gd, Gg, Gg^Fds, Gg, Gs^Fds, Gs^Fds, Hh
Gs, Gg, Gg, Gg^Edb, Gs, Gg^Edb, Gg^Edb, Gg, Gg, Gg, Gg, Gg, Gg, Gg, Gg, Hh, Gg, Gg, Gg, Gs^Fds, Gg, Gs, Gg, Hh, Gs^Fds, Gs^Fds, Gs^Fds, Gs^Fds, Gs^Fds, Hh
Hh, Gg, Gg, Gs, Hh, Gg, Gs, Gg, Gd, Gs, Gg^Fds, Gg, Hh, Gg^Fds, Gs, Gg, Gg, Gg, Gs, Gg^Fds, Gs^Fds, Gs^Fds, Gs^Fds, Gs^Fds, Wwg, Wwg, Wwg, Wwg, Hh, Gs^Fds
