Md, Md, Md, Md, Md, Md, Md, Md, Md, Md, Md, Md, Md, Md, Md, Md, Ql, Ql, Ql, Ql, Md, Md, Md, Md, Md, Md, Md, Md, Md, Md, Md, Md
Uu, Md, Uu, Uu, Uu, Uu, Md, Uu, Md, Md, Uu, Uu, Uu, Md, Uh, Md, Ql, Ql, Md, Uu, Md, Uu, Uu, Md, Uu, Md, Uu, Md, Md, Md, Qlf, Md
Md, Uu, Ur, Uh, Ur, Urb, Ur, Urb, Ur, Urb, Qlf, Ur, Uh, Uh, Ql, Ql^Bs\, Ql^Bs\, Ql, Uh, Uh, Uh, Ur, Ur, Ur, Uh, Ur, Ur, Ur, Ur, Urb, Md, Md
Md, Md, Ur, Ur, Uh, Uu, Ur, Uh, Qlf, Qlf, Qlf, Qlf, Uu, Uh, Ur, Ql, Ql, Uu, Uu, Qlf, Ur, Ur, Uu, Uu, Ur, Uu, Uh, Ur, Urb, Ur, Uu, Md
Md, Uu, Ur, Ur, Urb, Uu^Vd, Urb, Ur, Qlf, Qlf, Mv, Ur, Urb, Uu, Uu, Ql, Ql, Uu, Uu, Uu, Uu, Ur, Uh, Uu, Urb, Uh, Uu, Urb, Ur, Ur, Md, Md
Md, Uu, Urb, Uh, Ur, Urb, Uh, Uu, Ur, Qlf, Ur, Uu, Uu, Md, Md, Ql, Ql, Ql, Ur, Ur, Uh, Ur, Ur, Ur, Uh, Urb, Urb, Ur, Uu, Uu, Uu, Md
Md, Md, Urb, Uh, Ur, Ur, Ur, Ur, Ur, Ur, Urb, Uh, Ur, Md, Md, Uh, Ql, Ql, Ql, Ur, Ur, Ur, Ur, Uh, Ql, Ur, Ql, Uu, Ql, Uu, Md, Md
Md, Uu, Ur, Urb, Ur, Ur, Uh, Ur, Uu, Ur, Uh, Urb, Ur, Md, Md, Md, Ql, Ql, Ql, Urb, Ur, Uh, Ql, Ql, Ql, Ql, Ur, Ql^Bs|, Uu, Ql, Ql, Ql
Md, Md, Uh, Urb, Uu, Uu, Uu, Ur, Uh, Uu, Ur, Uu, Uh, Urb, Urb, Ur, Ql, Ql, Hhd, Hhd, Md, Hhd, Ql, Md, Md, Hhd, Ur, Urb, Uh, Ur, Md, Md
Md, Md, Ur, Urb, Ur, Ur, Uu, Ur, Ur^Vd, Ur, Ur, Uu, Uh, Ur, Ur, Ql, Ql, Ql, Uu, Md, Ql, Ql, Md, Md, Hhd, Ur, Uu, Urb, Urb^Vd, Ur, Uu, Md
Md, Md, Uu, Ur, Uu, Uu, Ur, Ur, Urb, Uh, Uu, Urb, Ur, Ur, Ur, Ql, Ql, Ql, Uu, Hhd, Ql, Hhd, Hhd^Fdw, Urb, Urb, Hhd, Urb^Ebn, Urb, Ur, Uh, Uu, Md
Md, Md, Ur, Ur, Ce, Ql, Ql, Ur, Ur, Urb, Hhd, Hhd, Hhd, Ur, Uh, Ql, Ql, Ql, Uu, Uh, Ql, Ur, Ur, Ur, Urb, Cte, Cte, Cte, Ur, Urb, Md, Md
Urb^Dr, Urb^Es, Urb, Ce, 1 Ke, Ce, Urb, Uu, Uu, Urb, Hhd, Hhd^Fdw, Hhd^Fdw, Uh, Ql, Ql, Rr^Vd, Ql^Bs/, Ql, Uu, Ql, Ur, Urb, Ur, Ur^Ebn, Cte, 2 Kh, Cte, Urb^Ebn, Urb, Uu, Md
Urb^Es, Urb^Es, Urb^Es, Ce, Ce, Ce, Urb, Uh, Ur, Ur, Hhd, Hhd, Hhd, Uh, Ql^Bs/, Ql^Bs/, Ql, Ql, Ql, Uu, Ql, Hhd, Urb, Urb, Urb, Uu, Cte, Ur, Urb, Ur, Md, Md
Md, Urb^Es, Urb, Ur, Ur, Urb, Uu, Urb, Urb, Uh, Urb, Urb, Uh, Urb, Ql, Ql, Ql, Ql, Ql, Uh, Ur, Ql, Ql, Hhd, Ur, Ur, Ur, Uu, Ur, Uh, Md, Md
Md, Md, Hhd, Uu, Md, Ur, Ur, Uh, Qlf, Urb, Qlf, Ur, Ur, Urb, Urb, Ql, Ql, Ql, Ql, Md, Uh, Hhd, Ql, Ql, Mv, Urb, Uh, Ur, Urb, Ur, Uu, Md
Md, Md, Hhd, Hhd^Fdw, Hhd, Uh, Ur, Qlf, Qlf, Qlf, Qlf, Ur, Uu, Uu, Ur, Ql^Bcx\, Ql, Ql, Ql, Md, Hhd, Ur, Ql, Ql, Ql, Ql, Ql, Urb, Ql, Uh, Ql, Md
Md, Uu, Hhd, Ur, Hhd, Urb, Ur, Qlf, Qlf, Qlf, Qlf, Uh, Urb, Md, Md, Ql, Ql, Ql^Bcx\, Urb, Md, Uh, Ur, Uh, Hhd, Uu, Ql, Ur, Ql^Bs|, Ql, Ql, Ql, Ql
Md, Md, Ur, Ur, Ur, Ur, Ur, Ur, Uh, Qlf, Ur, Urb, Hhd, Md, Md, Ql, Ql, Md, Md, Urb, Md, Urb, Uu, Hhd^Fdw, Hhd^Fdw, Hhd, Uh, Uh, Uh, Uu, Uu, Md
Md, Uu, Ur, Uu, Uh, Urb, Uh, Uh, Uh, Uu, Ur, Urb, Md, Md, Md, Ql, Ql, Md, Md, Md, Md, Md, Uu, Hhd^Fdw, Hhd, Hhd, Urb, Urb^Vd, Urb, Ur, Uu, Md
Md, Md, Ur, Uh, Uu^Vd, Ur, Uh, Ur, Uh, Uu, Qlf, Ur, Uh, Uu, Hhd, Ql, Ql, Ql, Hhd, Md, Uh, Ur, Urb, Urb, Uu, Urb, Uu, Uh, Ur, Urb, Uu, Md
Md, Md, Ur, Ur, Uh, Uu, Uu, Urb, Ur, Ur, Ur, Uu, Urb, Ur, Ql, Ql, Ql, Ql, Hhd, Hhd^Fdw, Uh, Ur, Uu, Ur, Ur, Ur, Urb, Urb, Ur, Ur, Md, Md
Uu, Uu, Md, Md, Md, Uu, Md, Uu, Md, Md, Md, Uu, Uu, Md, Ql, Ql, Mv, Uu, Md, Md, Md, Uu, Uu, Md, Uu, Uu, Uu, Md, Md, Md, Md, Md
Md, Md, Md, Md, Md, Md, Md, Md, Md, Md, Md, Md, Ql, Ql, Ql, Ql, Md, Md, Md, Md, Md, Md, Md, Md, Md, Md, Md, Md, Md, Md, Md, Md
