border_size=1
usage=map

Mm, Mm, Mm, Hh, Hh, Hh, Hh, Mm, Mm, Mm, Mm, Mm, Hh, Hh, Hh, Hh, Mm, Mm, Mm, Mm, Mm, Hh, Hh, Hh, Hh, Mm, Mm, Mm, Mm, Mm
Mm, Mm, Hh, Hh, Hh, Gg, Hh, Hh, Mm, Mm, Mm, Hh, Hh, Gg, Hh, Hh, Mm, Mm, Mm, Mm, Hh, Hh, Gg, Hh, Hh, Mm, Mm, Mm, Mm, Mm
Mm, Hh, Hh, Gg, Gg, Gg, Gg, Hh, Hh, Mm, Hh, Hh, Gg, Gg, Gg, Hh, Hh, Mm, Mm, Hh, Hh, Gg, Gg, Gg, Hh, Hh, Mm, Mm, Mm, Mm
Hh, Hh, Gg, Gg, Gg, Gg, Gg, Gg, Hh, Hh, Hh, Gg, Gg, Gg, Gg, Gg, Hh, Hh, Hh, Hh, Gg, Gg, Gg, Gg, Gg, Hh, Hh, Mm, Mm, Mm
Hh, Gg, Gg, Gg, Gg^Vh, Gg, Gg, Gg, Gg, Hh, Gg, Gg, Gg, Gg, Gg, Gg, Gg, Hh, Hh, Gg, Gg, Gg, Gg, Gg, Gg, Gg, Hh, Hh, Mm, Mm
Gg, 1 Ke, Ce, Ce, Gg, Gg, Gg, Gg, Gg, Gg, Gg, Gg, Gg, Gg, Gg, Gg, Gg, Gg, Gg, Gg, Gg, Gg, Gg, Gg, Gg, Gg, Gg, Hh, Mm, Mm
Gg, Ce, Ce, Gg, Gg, Gg, Gg, Gg, Gg, Gg, Gg, Gg, Gg, Gg, Gg, Gg, Gg, Gg, Gg, Gg, Gg, Gg, Gg, Gg, Gg, Gg, Gg, Hh, Hh, Mm
Gg, Ce, Gg, Gg, Gg, Gg, Gg, Gg, Gg, Gg, Gg^Vh, Gg, Gg, Gg, Gg, Gg, Gg, Gg, Gg, Gg, Gg, Gg, Gg, Gg, Gg, Gg, Hh, Hh, Mm, Mm
Hh, Gg, Gg, Gg, Gg, Gg, Gg, Gg, Gg, Gg, Gg, Gg, Gg, Gg, Gg, Gg, Gg, Gg, Gg, Gg, Gg, Gg, Hh^Vhh, Gg, Gg, Hh, Hh, Mm, Mm, Mm
Hh, Hh, Gg, Gg, Gg, Gg, Gg, Gg, Gg, Gg, Gg, Gg, Gg, Gg, Gg, Gg, Gg, Gg, Gg, Gg, Gg, Hh, Hh, Hh, Hh, Hh, Mm, Mm, Mm, Mm
Hh, Hh, Hh, Gg, Gg, Gg, Gg, Gg, Gg, Gg, Gg, Gg, Gg, Gg, Gg, Gg, Gg, Gg, Gg, Gg, Hh, Hh, Mm, Hh, Hh, Mm, Mm, Mm, Mm, Mm
Hh, Hh, Gg, Gg, Gg, Gg, Gg, Gg, Gg, Gg, Gg, Gg, Gg, Gg, Gg, Gg, Gg, Gg, Gg, Gg, Gg, Hh, Hh, Hh, Hh, Hh, Mm, Mm, Mm, Mm
Hh, Gg, Gg, Gg, Gg, Gg, Gg, Gg, Gg, Gg, Gg, Gg, Gg, Gg, Gg, Gg, Gg, Gg, Gg, Gg, Gg, Gg, Hh^Vhh, Gg, Gg, Hh, Hh, Mm, Mm, Mm
Gg, Gg, Gg, Gg, Gg^Vh, Gg, Gg, Gg, Gg, Gg, Gg, Gg, Gg, Gg, Gg, Gg, Gg, Gg, Gg, Gg, Gg, Gg, Gg, Gg, Gg, Gg, Hh, Hh, Mm, Mm
Hh, Gg, Gg, Gg, Gg, Gg, Gg, Gg, Gg, Gg, Gg^Vh, Gg, Gg, Gg, Gg, Gg, Gg, Gg, Gg, Gg, Gg, Gg, Gg, Gg, Gg, Gg, Gg, Hh, Mm, Mm
Hh, Hh, Gg, Gg, Gg, Gg, Gg, Gg, Hh, Hh, Hh, Gg, Gg, Gg, Gg, Gg, Hh, Hh, Hh, Hh, Gg, Gg, Gg, Gg, Gg, Hh, Hh, Mm, Mm, Mm
Mm, Hh, Hh, Gg, Gg, Gg, Hh, Hh, Mm, Mm, Hh, Hh, Gg, Gg, Hh, Hh, Mm, Mm, Mm, Hh, Hh, Gg, Gg, Hh, Hh, Mm, Mm, Mm, Mm, Mm
Mm, Mm, Hh, Hh, Hh, Hh, Hh, Mm, Mm, Mm, Mm, Hh, Hh, Hh, Hh, Mm, Mm, Mm, Mm, Mm, Hh, Hh, Hh, Hh, Mm, Mm, Mm, Mm, Mm, Mm
