1 Ke, Ce, Ce
Ce, Ce, Ce
Ce, Ce, Ce