border_size=1
usage=map

Gg^Vh, Gg^Vh, Gg^Vh, Gg^Vh, Gg^Vh
Gg^Vh, Rr, Rr, Rr, Gg^Vh
Gg^Vh, Rr, Rr^Ecf, Rr, Gg^Vh
Gg^Vh, Rr, Rr, Rr, Gg^Vh
Gg^Vh, Gg^Vh, Gg^Vh, Gg^Vh, Gg^Vh
